1111111111111111111
11E00000C00000000P1
1000000000000000001
1111111111111111111
1000C000WXYZ0000001
1111111111111111111
