## MAIN MAP ##
1111111111111111111
1CCCCCCCC1CCCCCCCC1
1C11C111C1C111C11C1
1CCCCCCCCCCCCCCCCC1
1C11C1C11111C1C11C1
1CCCC1CCC1CCC1CCCC1
1111C111010111C1111
1111C100000001C1111
1111C100000001C1111
1T0CC00WX0YZ00CC0t1
1111C100000001C1111
1111C100000001C00E1
1111C101111101C1111
1CCCCCCCC1CCCCCCCC1
1C11C111C1C111C11C1
1CC1CCCCCCCCCCC1CC1
11C1C1C11111C1C1C11
1CCCC1CCC1CCC1CCCC1
1C111111C1C111111C1
1CCCCCCCCCCCCCCCCP1
1111111111111111111


## DEBUG MAP ##
1111111111111111111
1E000000C00000000P1
1000000000000000001
1111111111111111111
10000000WXYZ0000001
1111111111111111111


## 42 MAP ##
111111111111111111111111111111111111111111111111111111111111
100000000000000000000000000000000000000000000000000000000001
100000000000000000000000001111110001111110111110000000000001
100000000000000WXYZ00000010000100001000101000001000000000001
100000000000000000000000100001000001001001000001000000000001
100000000000000000000001000010000001010001000001000000000001
100000000000000000000010000100000001100001000001000000000001
100000000000000000000100001000000001000001000001000000000001
100000000000000000001000010000000000000001000010000000000001
100000000000000000010000100000000000000010000100000000000001
100000000000000000100001000000000000000100001000000000000001
100000000000000001000010000000000000001000010000000000000001
100000000000000010000100000000000000010000100000000000000001
100000000000000100001000000000000000100001000000000000000001
100000000000001000010000000000000001000010000001000000000001
100000000000010000100000000000000001000010000011000000000001
100000000000100001111111111111110001000010000101000000000001
100000000000100000000000000000010001000010001001000000000001
100000000000100000000000000000010001000010010001000000000001
100000000000100000000000000000010001111110111111000000000001
100000000000111111111111111000010000000000000000000000000001
100000000000000000000000001000010000000000000000000000000001
100000000000000000000000001000010000000000000000000000000001
100000000000000000000000001000010000000000000000000000000001
100000000000000000000000001000010000000000000000000000000001
100000000000000000000000001000010000000000000000000000000001
100000000000000000000000001000010000000000000000000000000001
10000000000E0000000000000011111100000000000000C0P00000000001
100000000000000000000000000000000000000000000000000000000001
100000000000000000000000000000000000000000000000000000000001
111111111111111111111111111111111111111111111111111111111111
